00000000000000000000000000000000000000000000000000
01111111111111111111111111111111111111111111111110
01111111111111111111111111111111111111111111111110
01111111100001111111111111111111000011111100011110
01111111000001111111111000011111100000111111111110
01111100000011111110000111100001111111111111111110
01111111111111111110000111100001111100000000000000
01111111111111111111111111111111111100000000000000
01111111000111111111111111111111111111111111000000
01111111000111111111111111110000000111111111000000
01111111000111111111111111110000000111111111000000
01111111111111111100111111110000000111111111111110
01111111111111111100111111111111111111111111111110
01111111111111111100000111111111111111111111111110
01111111111000000000000111111111111111111111111110
01111111111000000000111111111110000001111111111110
01111111111111111111111111111110000001111111111110
01111111111111111111111111111110000001111111111110
00000000000111111100111111111111111111111111100000
00000000000111111100000000000000111111111100000000
01111111111111111100000000000111111111100000000000
01111111111111111100000000111111111100000000000000
01111111000111111100000111111111100000000000000000
01111111000111111100111111111100000001111111111110
01111111000111111100111111111100000001111111111110
01111111000111111100111111111111111111111111111110
01111000000000111100111111111111111111111000011110
01111000000000111100111111111111111111111000011110
01111111000111111100111111110000111111111000011110
01111111000111111100111111110000111111111000011110
01111111000111111100111111110000111111111111111110
01111111000111111100111111110000111111111111111110
01111111111111111111111111111111111111111111111110
01111111111111111111111111111111111000011111111110
01111111111111111111111111111111111000011111111110
01111111111111111111111111111111111000011111111110
01111111100000000000000000001111111000011111111110
01111111100000000000000000001111111111111111111110
01111111110000111111111111111111111111111100000000
01111111110000111111111111111111111111111100000000
01111111111111111111111111110000011111111111110000
01111111111111111111111111110000011111111111110000
01111111111111110000011111110000011111111100000000
01111111111111110000011111110000011111111100000000
01111100000111110000011111110000011111111111111110
01111100000111110000011111111111111111111111111110
01111100000111110000011111111111111110000111111110
01111100000111111111111111111111111110000111111110
01111111111111111111111111111111111110000111111110
00000000000000000000000000000000000000000000000000