00000000000000000000000000000000000000000000000000
01111111111111111111111111111111111111111111111110
01111110000001111111111111111100000011111111111110
01111110000001111111111111111100000011111111111110
01111111111111111111111111111111111111111111111110
00000111111111111111100000000000001111111111111110
01111111111101111111111111111111111111111111111110
01111111111101111111111111111111111111111101111110
01111111111101111111111111100000011111111101111110
01111111111101111111111111111111111111111101111110
01111111111101111111111111111111111111111101111110
01111111111101111111111111100000011111111101111110
01111111111111111111111111111111111111111101111110
00000111111111111111111111111111111111111111111110
00000000000011111111111111111111111111111111111110
01111111111111111111100000000000000011111111111110
01111111111111111111111111111111111111111111111110
00000000011111111111111111111111111111111111111110
01111111111111111111111111111111111111110000000000
01111111111111111111111111111111111111111111111110
01111111110000000000000000000000011111111111111110
01111111111111111111111111111111111111111111111110
01111111111111111111111111111111111111111111111110
01111111111111111111111111111111111111110111111110
01111110000001111111111111111111111111110111111110
01111111111111111111111111111111111111110111111110
01111111111111111100000000001111111111110111111110
01111111001111111111111111111111111111110111111110
01111111111111111111111111111111111111110111111110
01111111111111111111111111111111111111110111111110
01111111111111111111111111111111111111111111111110
01111111100000000000001111111111111111111111111110
01111111111111101111111111111111100000001111111110
01111111111111101111111111111111111111111111111110
01111111111111101111111011111111111111111111111110
01111111111111111111111111111111111111111111111110
01111111111111111111111111111111111111111111111110
01111111111110000000000000000000000111111111111110
01111111111111111111111111111111111111111111111110
01111111111111111111111111111111111111111111111110
01111111111111111111111111111111111111111111111110
01111100000000000111111111111111111111111111111110
01111111111111111111111111111111111111111111111110
01111111111111111111111111100000000000000001111110
01111111111111111111111111111111111111111111111110
01111111110111111111111111111111111111111111111110
01111111110111111111110000000111111111111111111110
01111111110111111111111111111111111111000000011110
01111111110111111111111111111111111111111111111110
00000000000000000000000000000000000000000000000000